############
#P.T..#...T#
#.....X....#
#X....#....#
###...#X...#
#.........T#
#....X...###
#X......T..#
#..T.#.....#
#....#....X#
#T..X#X...T#
############