################
##..T..........#
##.............#
##.............#
###............#
###............#
###............#
##............##
##............##
##............##
#.........P...##
################