P..#########
#..........#
#..........#
#..........#
#..........#
#..........#
#..........#
#..........#
#..........#
#..........#
#..........#
############
