P..#########
#TX....XXXT#
#........X.#
#..........#
#...###..X.#
X.....#..T.#
#..X..#....#
#.....##T..#
#..T.......#
#....#.X...X
#....#XTT..#
#TX#########