############
#P.T...XXXT#
#........X.#
#..........#
#...###..X.#
#.X...#..T.#
#..X..#....#
#.....##T..#
#..T.......#
#....#.X...X
#TX..#XTT..#
############