#####
#P..#
#TX.#
#.T.#
#####
