###########
#P..###X###
#.#####...#
#..####...#
##.####T###
#...###.#T#
#X#.......#
##T.#.##T.#
###.#.###.#
#####X#####
###########
