############
#P.....XXXT#
#........X.#
#..........#
#...###..X.#
#.....#..T.#
#..X..#....#
#.....##T..#
#..T.......#
#....#.....X
#TX..#XTT..#
############
