############
#P.........#
#..........#
#..........#
#X......#..#
#..........#
#..........#
#..........#
#..........#
#....#.....X
#....#.....#
############
