#####
#P..#
#.X.#
#.T.#
#####
