############
#P.T......T#
#..........#
#..........#
#..........#
#..........#
#..........#
#..........#
#..T.......#
#....#.....X
#T...#.....#
############
