############
#P....#...T#
#.....X....#
#X....#....#
###...#X...#
#.........T#
#....X...###
#X......T..#
#....#.....#
#....#....X#
#T..X#X...T#
############
