###########
#P..###X###
#.#####...#
#..####...#
##.####.###
#...###.#.#
#X#.......#
##..#.##..#
###.#.###.#
#####X#####
###########
