#####
#P..#
#.X.#
#...#
#####
