###########
#P.T###X###
#.#####...#
#..####...#
##.####T###
#...###.#T#
#X#.......#
##T.#.##T.#
###.#.###.#
#####X#####
###########