###########
#..P###X###
#.#####...#
#..####...#
##.####T###
#...##X.#T#
#X#.......#
##T.#.##T.#
###.#.###X#
#####X#####
###########
