############
#P.........#
#..........#
#..........#
#X......#..#
#..........#
#..........#
#.......T..#
#..T.......#
#....#.....X
#T...#.....#
############
